########################################
#                 ...                  #
#                 ...                  #
#                 ...                  #
#            .      .                  #
#   $  $   $  $   $  $  $  $  $  $  $  #
#                                      #
#                                      #
#                    @                 #
########################################
