###########
# .   .   #
#         #
#  $   $  #
##   #    #
# #   #   #
#        @#
###########
