########################
#           ..         #
#           ..         #
#           .          #
#   $  $   $  $   $    #
#                      #
#                    @ #
########################
