##########
#   #   ##
#.#      #
#    #   #
#      # #
# # # $ ##
# @  $ . #
##########
