############################
#                          #
#                          #
#                          #
#                          #
#                          #
#                          #
#                          #
#                          #
#                          #
#                          #
#.                         #
#                          #
#                          #
#     $                    #
# @  $ .                   #
############################