##################################################
#                                               @#
#                                                #
#                                                #
#                                                #
#                                                #
#                                                #
#                                                #
#                                                #
#                                                #
#                                                #
#                                                #
#                                                #
#                                                #
#                                                #
#                                                #
#  .                                             #
# $                                              #
#                                                #
##################################################
