  #####
  #   #
  # $ #
  # . #
  # @ #
  #####
