########
#   #  #
# $  . #
# .  $ #
#  @#  #
########
