  ####
###  ##
# $   #
# # # #
# $ # #
# $@$$#
#.....#
#######