########
#@     #
#  $   #
#     .#
#  $####
# .  # #
########