      ###
   ####@##
####...*.##
#   .#*.###
# $ ## $ ##
###  #   #
  # $  $ #
  ###$ $ #
    #    #
    ######