##################################################
#                                                #
#                                              $ #
#                                             .  #
#                                                #
#                                                #
#                                                #
#                                                #
#                                                #
#                                                #
#                                                #
#                                                #
#                                                #
#                                                #
#                                                #
#                                                #
#                                                #
#                                                #
#@                                               #
##################################################
