###########
#   .    @#
# .$ $$$  #
#$$ .$ $$ #
#......*..#
# $.$$$.$ #
#   . .$  #
###########