#######
#     #
# $ . #
#   # #
# . $ #
# # @ #
#   $ #
#   . #
#######
