###################################
#                                .#
# @                               #
#   $                             #
##$ .                             #
#                                 #
###################################
